1111111111111111111111111111111111
1CE000000000000C0000C0000000000001
101C010100100000101001000000010101
1010010010101010001001000000010101
10000000PC00C0000000000000000000C1
1111111111111111111111111111111111
