1111111111111
10C1000000001
100E011111001
10011P0000001
1111111111111
